#########################
#########################
#########################
###*******************###
###*******************###
###*******************###
###*******************###
###*******************###
###*******************###
###*******************###
###*******************###
###*******************###
###*******************###
###*******************###
###*******************###
###*******************###
###*******************###
###*******************###
###*******************###
###*******************###
###*******************###
###*******************###
#########################
#########################
#########################